{
    "width" : 40,
    "depth" : 55,

    "sunlight" : [ 0, 1, 0 ],

    "altitude" : [
        0, 0, 0, 0, 0, 0, 0, 0, 0, 0, 0, 0, 0, 0, 0, 0, 0, 0, 0, 0, 0, 0, 0, 0, 0, 0, 0, 0, 0, 0, 0, 0, 0, 0, 0, 0, 0, 0, 0, 0,
        0, 1, 1, 1, 1, 1, 1, 1, 1, 0, 0, 0, 0, 0, -1, -1, -1, -1, -1, -1, -1, 0, 0, 0, 0, 0, 0, 0, 0, 0, 0, 0, 0, 0, 0, 0, 0, 0, 0, 0,
        0, 1, 1, 1, 1, 1, 1, 1, 1, 0, 0, 0, 0, 0, -1, -1, -1, -1, -1, -1, -1, 0, 0, 0, 0, 0, 0, 0, 0, 0, 1, 0, 0, 0, 0, 0, 0, 0, 0, 0,
        0, 1, 1, 1, 1, 1, 1, 1, 1, 0, 0, 0, 0, 0, -1, -1, -3, -3, -3, -1, -1, 0, 0, 0, 0, 0, 0, 0, 0, 1, 1, 1, 0, 0, 0, 0, 0, 0, 0, 0,
        0, 1, 1, 2, 2, 2, 2, 1, 1, 0, 0, 0, 0, 0, -1, -1, -3, -3, -3, -1, -1, 0, 0, 0, 0, 0, 0, 0, 1, 1, 1, 1, 1, 0, 0, 0, 0, 0, 0, 0,
        0, 1, 1, 2, 3, 3, 2, 1, 1, 0, 0, 0, 0, 0, -1, -1, -3, -3, -3, -1, -1, 0, 0, 0, 0, 0, 0, 0, 0, 1, 1, 1, 0, 0, 0, 0, 0, 0, 0, 0,
        0, 1, 1, 2, 3, 3, 2, 1, 1, 0, 0, 0, 0, 0, -1, -1, -1, -1, -1, -1, -1, 0, 0, 0, 0, 0, 0, 0, 0, 0, 1, 0, 0, 0, 0, 0, 0, 0, 0, 0,
        0, 1, 1, 2, 2, 2, 2, 1, 1, 0, 0, 0, 0, 0, -1, -1, -1, -1, -1, -1, -1, 0, 0, 0, 0, 0, 0, 0, 0, 0, 0, 0, 0, 0, 0, 0, 0, 0, 0, 0,
        0, 1, 1, 1, 1, 1, 1, 1, 1, 0, 0, 0, 0, 0, -1, -1, -1, -1, -1, -1, -1, 0, 0, 0, 0, 0, 0, 0, 0, 0, 0, 0, 0, 0, 0, 0, 0, 0, 0, 0,
        1, 1, 1, 1, 1, 1, 1, 1, 1, 0, 0, 0, 0, 0, 0, 0, 0, 0, 0, 0, 0, 0, 0, 0, 0, 0, 0, 0, 0, 0, 0, 0, 0, 0, 0, 0, 0, 0, 0, 0,
        1, 1, 1, 1, 1, 1, 1, 1, 1, 0, 0, 0, 0, 0, 0, 0, 0, 0, 0, 0, 0, 0, 0, 0, 0, 0, 0, 0, 0, 0, 0, 0, 0, 0, 0, 0, 0, 0, 0, 0,
        1, 1, 1, 1, 1, 1, 1, 1, 1, 0, 0, 0, 0, 0, 0, 0, 0, 0, 0, 0, 0, 0, 0, 0, 0, 0, 0, 0, 0, 0, 0, 0, 0, 0, 0, 0, 0, 0, 0, 0,
        1, 1, 1, 1, 1, 1, 1, 1, 1, 0, 0, 0, 0, 0, 0, 0, 0, 0, 0, 0, 0, 0, 0, 0, 0, 0, 0, 0, 0, 0, 0, 0, 0, 0, 0, 0, 0, 0, 0, 0,
        2, 2, 2, 2, 2, 2, 2, 1, 1, 0, 0, 0, 0, 0, 0, 0, 0, 0, 0, 0, 0, 0, 0, 0, 0, 0, 0, 0, 0, 0, 0, 0, 0, 0, 0, 0, 0, 0, 0, 0,
        2, 2, 2, 2, 2, 2, 2, 2, 1, 0, 0, 0, 0, 0, 0, 0, 0, 0, 0, 0, 0, 0, 0, 0, 0, 0, 0, 0, 0, 0, 0, 0, 0, 0, 0, 0, 0, 0, 0, 0,
        2, 2, 2, 2, 2, 2, 2, 2, 1, 0, 0, 0, 0, 0, 0, 0, 0, 0, 0, 0, 0, 0, 0, 0, 0, 0, 0, 0, 0, 0, 0, 0, 0, 0, 0, 0, 0, 0, 0, 0,
        2, 2, 2, 2, 2, 2, 2, 2, 1, 0, 0, 0, 0, 0, 0, 0, 0, 0, 0, 0, 0, 0, 0, 0, 0, 0, 0, 0, 0, 0, 0, 0, 0, 0, 0, 0, 0, 0, 0, 0,
        3, 3, 3, 3, 3, 3, 3, 2, 1, 0, 0, 0, 0, 0, 0, 0, 0, 0, 0, 0, 0, 0, 0, 0, 0, 0, 0, 0, 0, 0, 0, 0, 0, 0, 0, 0, 0, 0, 0, 0,
        3, 3, 3, 3, 3, 3, 3, 2, 1, 0, 0, 0, 0, 0, 0, 0, 0, 0, 0, 0, 0, 0, 0, 0, 0, 0, 0, 0, 0, 0, 0, 0, 0, 0, 0, 0, 0, 0, 0, 0,
        3, 3, 3, 3, 3, 3, 3, 2, 1, 0, 0, 0, 0, 0, 0, 0, 0, 0, 0, 0, 0, 0, 0, 0, 0, 0, 0, 0, 0, 0, 0, 0, 0, 0, 0, 0, 0, 0, 0, 0,
        3, 3, 3, 3, 3, 3, 3, 2, 1, 0, 0, 0, 0, 0, 0, 0, 0, 0, 1, 1, 1, 1, 1, 1, 1, 1, 1, 1, 1, 1, 1, 1, 1, 1, 1, 1, 0, 0, 0, 0,
        4, 4, 4, 4, 4, 4, 4, 2, 1, 0, 0, 0, 0, 0, 0, 0, 0, 0, 1, 2, 2, 2, 2, 2, 2, 2, 2, 2, 2, 2, 2, 2, 2, 2, 2, 1, 0, 0, 0, 0,
        4, 4, 4, 4, 4, 4, 4, 2, 1, 0, 0, 0, 0, 0, 0, 0, 0, 0, 1, 2, 3, 3, 3, 3, 3, 3, 3, 3, 3, 3, 3, 3, 3, 3, 2, 1, 0, 0, 0, 0,
        4, 4, 4, 4, 4, 4, 4, 2, 1, 0, 0, 0, 0, 0, 0, 0, 0, 0, 1, 2, 3, 4, 4, 4, 4, 4, 4, 4, 4, 4, 4, 4, 4, 3, 2, 1, 0, 0, 0, 0,
        4, 4, 4, 4, 4, 4, 4, 2, 1, 0, 0, 0, 0, 0, 0, 0, 0, 0, 1, 2, 3, 4, 4, 4, 4, 4, 4, 4, 4, 4, 4, 4, 4, 3, 2, 1, 0, 0, 0, 0,
        4, 4, 4, 4, 4, 4, 4, 2, 1, 0, 0, 0, 0, 0, 0, 0, 0, 0, 1, 2, 3, 4, 4, 4, 3, 3, 3, 3, 3, 3, 3, 4, 4, 3, 2, 1, 0, 0, 0, 0,
        5, 5, 5, 5, 5, 5, 5, 2, 1, 0, 0, 0, 0, 0, 0, 0, 0, 0, 1, 2, 3, 4, 4, 4, 3, 3, 3, 3, 3, 3, 3, 4, 4, 3, 2, 1, 0, 0, 0, 0,
        5, 5, 5, 5, 5, 5, 5, 2, 1, 0, 0, 0, 0, 0, 0, 0, 0, 0, 1, 2, 3, 4, 4, 4, 3, 3, 3, 3, 3, 3, 3, 4, 4, 3, 2, 1, 0, 0, 0, 0,
        5, 5, 5, 5, 5, 5, 5, 2, 1, 0, 0, 0, 0, 0, 0, 0, 0, 0, 1, 2, 3, 4, 4, 4, 3, 3, 3, 3, 3, 3, 3, 4, 4, 3, 2, 1, 0, 0, 0, 0,
        5, 5, 5, 5, 5, 5, 5, 2, 1, 0, 0, 0, 0, 0, 0, 0, 0, 0, 1, 2, 3, 4, 4, 4, 3, 3, 3, 3, 3, 3, 3, 4, 4, 3, 2, 1, 0, 0, 0, 0,
        5, 5, 5, 5, 5, 5, 5, 2, 1, 0, 0, 0, 0, 0, 0, 0, 0, 0, 1, 2, 3, 4, 4, 4, 4, 4, 4, 4, 4, 4, 4, 4, 4, 3, 2, 1, 0, 0, 0, 0,
        5, 5, 5, 5, 5, 5, 5, 2, 1, 0, 0, 0, 0, 0, 0, 0, 0, 0, 1, 2, 3, 3, 4, 4, 4, 4, 4, 4, 4, 4, 4, 4, 4, 3, 2, 1, 0, 0, 0, 0,
        5, 5, 5, 5, 5, 5, 5, 2, 1, 0, 0, 0, 0, 0, 0, 0, 0, 0, 1, 2, 2, 3, 4, 4, 4, 4, 4, 4, 4, 4, 4, 3, 3, 3, 2, 1, 0, 0, 0, 0,
        6, 6, 6, 6, 6, 6, 6, 2, 1, 0, 0, 0, 0, 0, 0, 0, 0, 0, 1, 1, 2, 3, 4, 4, 4, 4, 4, 4, 4, 3, 3, 3, 2, 2, 2, 1, 0, 0, 0, 0,
        7, 7, 7, 7, 7, 7, 7, 2, 1, 0, 0, 0, 0, 0, 0, 0, 0, 0, 0, 1, 2, 3, 4, 4, 4, 4, 4, 4, 4, 3, 2, 2, 2, 1, 1, 1, 0, 0, 0, 0,
        7, 7, 7, 7, 7, 7, 7, 2, 1, 0, 0, 0, 0, 0, 0, 0, 0, 0, 0, 1, 2, 3, 3, 3, 3, 3, 3, 3, 3, 3, 2, 1, 1, 1, 0, 0, 0, 0, 0, 0,
        7, 7, 7, 7, 7, 7, 7, 1, 1, 0, 0, 0, 0, 0, 0, 0, 0, 0, 0, 1, 2, 2, 2, 2, 2, 2, 2, 2, 2, 2, 2, 1, 0, 0, 0, 0, 0, 0, 0, 0,
        7, 7, 7, 7, 7, 7, 7, 1, 1, 0, 0, 0, 0, 0, 0, 0, 0, 0, 0, 1, 1, 1, 1, 1, 1, 1, 1, 1, 1, 1, 1, 1, 0, 0, 0, 0, 0, 0, 0, 0,
        7, 7, 7, 7, 7, 7, 7, 1, 1, 0, 0, 0, 0, 0, 0, 0, 0, 0, 0, 0, 0, 0, 0, 0, 0, 0, 0, 0, 0, 0, 0, 0, 0, 0, 0, 0, 0, 0, 0, 0,
        7, 7, 7, 7, 7, 7, 7, 1, 1, 0, 0, 0, 0, 0, 0, 0, 0, 0, 0, 0, 0, 0, 0, 0, 0, 0, 0, 0, 0, 0, 0, 0, 0, 0, 0, 0, 0, 0, 0, 0,
        7, 7, 7, 7, 7, 7, 7, 1, 1, 0, 0, 0, 0, 0, 0, 0, 0, 0, 0, 0, 0, 0, 0, 0, 0, 0, 0, 0, 0, 0, 0, 0, 0, 0, 0, 0, 0, 0, 0, 0,
        6, 6, 6, 6, 6, 6, 6, 1, 1, 0, 0, 0, 0, 0, 0, 0, 0, 0, 0, 0, 0, 0, 0, 0, 0, 0, 0, 0, 0, 0, 0, 0, 0, 0, 0, 0, 0, 0, 0, 0,
        6, 6, 6, 6, 6, 6, 6, 1, 1, 0, 0, 0, 0, 0, 0, 0, 0, 0, 0, 0, 0, 0, 0, 0, 0, 0, 0, 0, 0, 0, 0, 0, 0, 0, 0, 0, 0, 0, 0, 0,
        6, 6, 6, 6, 6, 6, 6, 1, 1, 0, 0, 0, 0, 0, 0, 0, 0, 0, 0, 0, 0, 0, 0, 0, 0, 0, 0, 0, 0, 0, 0, 0, 0, 0, 0, 0, 0, 0, 0, 0,
        6, 6, 6, 6, 6, 6, 6, 1, 1, 0, 0, 0, 0, 0, 0, 0, 0, 0, 0, 0, 0, 0, 0, 0, 0, 0, 0, 0, 0, 0, 0, 0, 0, 0, 0, 0, 0, 0, 0, 0,
        6, 6, 6, 6, 6, 6, 6, 1, 1, 0, 0, 0, 0, 9, 9, 9, 9, 9, 0, 0, 0, 0, 0, 0, 0, 0, 1, 1, 1, 1, 1, 1, 1, 1, 1, 1, 1, 1, 1, 1,
        6, 6, 6, 6, 6, 6, 6, 1, 1, 0, 0, 9, 9, 9, 9, 9, 9, 9, 9, 0, 0, 0, 0, 0, 0, 0, 1, 2, 2, 2, 2, 2, 2, 2, 2, 2, 2, 2, 2, 2,
        6, 6, 6, 6, 6, 6, 6, 1, 1, 0, 0, 9, 9, 9, 9, 9, 9, 9, 9, 0, 0, 0, 0, 0, 1, 1, 1, 2, 3, 3, 3, 3, 3, 3, 3, 3, 3, 3, 3, 3,
        7, 7, 7, 7, 7, 7, 7, 1, 1, 8, 8, 9, 9, 9, 9, 9, 9, 9, 9, 0, 0, 0, 0, 0, 1, 1, 1, 2, 3, 4, 4, 4, 4, 4, 4, 4, 4, 4, 4, 4,
        7, 7, 7, 7, 7, 7, 2, 1, 1, 8, 8, 9, 9, 9, 9, 9, 9, 9, 9, 0, 0, 0, 0, 0, 1, 1, 1, 2, 3, 4, 5, 5, 5, 5, 5, 5, 5, 5, 5, 5,
        7, 7, 7, 7, 7, 7, 2, 1, 1, 8, 8, 9, 9, 9, 9, 9, 9, 9, 9, 0, 0, 0, 0, 0, 1, 1, 1, 2, 3, 4, 5, 6, 6, 6, 6, 6, 6, 6, 6, 6,
        7, 7, 7, 7, 7, 7, 2, 1, 1, 8, 8, 9, 9, 9, 9, 9, 9, 9, 9, 0, 0, 0, 0, 0, 7, 7, 7, 7, 7, 7, 7, 7, 7, 7, 7, 7, 7, 7, 7, 7,
        7, 7, 7, 7, 7, 7, 7, 7, 7, 8, 8, 8, 8, 8, 8, 8, 8, 8, 8, 7, 7, 7, 7, 7, 7, 7, 7, 7, 7, 7, 7, 7, 7, 7, 7, 7, 7, 7, 7, 7,
        7, 7, 7, 7, 7, 7, 7, 7, 7, 8, 8, 8, 8, 8, 8, 8, 8, 8, 8, 7, 7, 7, 7, 7, 7, 7, 7, 7, 7, 7, 7, 7, 7, 7, 7, 7, 7, 7, 7, 7,
        7, 7, 7, 7, 7, 7, 7, 7, 7, 8, 8, 8, 8, 8, 8, 8, 8, 8, 8, 7, 7, 7, 7, 7, 7, 7, 7, 7, 7, 7, 7, 7, 7, 7, 7, 7, 7, 7, 7, 7,
        
    ],

    "trees" : [
        {
            "x" : 1.5,
            "z" : 1.5
        },
        {
            "x" : 4.5,
            "z" : 4.5
        },
        {
            "x" : 34.5,
            "z" : 4.5
        },
        {
            "x" : 32.5,
            "z" : 4.5
        },
        {
            "x" : 35.5,
            "z" : 5.5
        },
        {
            "x" : 37.5,
            "z" : 4.9
        },
        {
            "x" : 36.5,
            "z" : 6.5
        },
        {
            "x" : 35.5,
            "z" : 3.5
        },
        {
            "x" : 36.8,
            "z" : 3.75
        },
        {
            "x" : 34.15,
            "z" : 7.5
        },
        {
            "x" : 35,
            "z" : 5.5
        },
        {
            "x" : 34.85,
            "z" : 7.5
        },
        {
            "x" : 35.95,
            "z" : 6.8
        },
        {
            "x" : 36.5,
            "z" : 6.5
        },
        {
            "x" : 35,
            "z" : 5.5
        },
        {
            "x" : 32.85,
            "z" : 7.5
        },
        {
            "x" : 32.95,
            "z" : 6.8
        },
        {
            "x" : 31.5,
            "z" : 6.5
        },
        {
            "x" : 30,
            "z" : 5.5
        },
        {
            "x" : 30.85,
            "z" : 7.5
        },
        {
            "x" : 30.25,
            "z" : 6.8
        },
        {
            "x" : 30.5,
            "z" : 3.5
        },
        {
            "x" : 31,
            "z" : 5.5
        },
        {
            "x" : 28.85,
            "z" : 7.5
        },
        {
            "x" : 29.95,
            "z" : 6.8
        },
        {
            "x" : 30.2,
            "z" : 4.5
        },
        {
            "x" : 15.2,
            "z" : 47.5
        }
    ],

    "roads" : [
        {
            "width" : 3,
            "spine": [
                9.5, 11,
                14.5, 13.5,
                16.5, 10.5,
                18.5, 18.0
            ]
        },
        {
            "width" : 2,
            "spine": [
                20.5, 10,
                30.5, 10,
                35.5, 10,
                37.5, 10
            ]
        },
        {
            "width" : 2,
            "spine": [
                10.5, 14,
                11.0, 20,
                10.0, 35,
                11.0, 38,
                15.0, 42,
                17.0, 42,
                25.2, 41,
                30.0, 42,
                36.5, 41,
                37.0, 41
            ]
        }
    ],
    
    "ponds" : [
    	{
            "x" : 27,
            "z" : 27,
            "width" : 3.5
        },
        {
            "x" : 18,
            "z" : 4,
            "width": 1
        }
    ]

}